.....##...#..#.#.#.#....
#.#..##........#.....###
.....##.......###.......
.....##......#####.....#
.....##.....#######.....
.....###...#########....
..........###########...
.........#############..
........###############.
.......#################
#....#.........#.#......
###..##...#.#.#........#
........................
........................
.....#####.#..#.#.#.#...
........................