.....##...#..#.#.#.#....
#.#..##........#.....###
.....##.......###.......
.....##......#####.....#
.....##.....#######.....
.....###...#............
..........#####....#####
..#...#...#####....#####
....##....#####....#####
#.#....#..#####....#####
#....#...#.#...#.#......
###..##...#.#.#........#
###..###..#..#.#.#.#...#
###..####..#.........##.
.....#####.#..#.#.#.#...
..#...##......#.........