.....#.#.#.#.#.#.#......
#.#...#.#.#.#.#.#.....#.
.......#.#.#.#.#.#......
.......#.#.#.#.#.#......
........................
..#..###...#............
.#.#.#.#.#.#.#.#.#.#.#.#
#.#.#.#.#.#.#.#.#.#.#.#.
..#.#.....######.#.#....
#.#....#..#............#
#....#....#......#.#....
###.......######......#
#....###..#....#.#.#...#
#.#.#.#.#...............
..........#..#.#.#.#...#
..#...##......#.........